{
	"tileset" : "pkmn.png",
	"terrain" : [
		[114, 113, 114, 113, 114, 105, 106, 105, 106, 105, 106, 105, 106, 105, 106, 105, 106, 105, 106, 105, 106, 105, 106, 105, 106, 105, 106, 113, 114, 113, 114, 113],
		[106, 105, 106, 105, 106, 113, 114, 113, 114, 113, 114, 113, 114, 113, 114, 113, 114, 113, 114, 113, 114, 113, 114, 113, 114, 113, 114, 105, 106, 105, 106, 105],
		[114, 113, 114, 113, 114, 105, 106, 105, 106, 105, 106, 105, 106, 105, 106, 105, 106, 105, 106, 105, 106, 105, 106, 105, 106, 105, 106, 113, 114, 113, 114, 113],
		[106, 105, 106, 105, 106, 113, 114, 113, 114, 113, 114, 113, 114, 113, 114, 113, 114, 113, 114, 113, 114, 113, 114, 113, 114, 113, 114, 105, 106, 105, 106, 105],
		[114, 113, 114, 113, 114, 121, 122, 121, 122, 121, 122, 121, 122, 121, 122, 121, 122, 121, 122, 121, 122, 121, 122, 121, 122, 121, 122, 113, 114, 113, 114, 113],
		[106, 105, 106, 105, 106,   2,   2,   2,   2,   8,   8,   8,   2,   2,   2,   2,   2,   2,   2,   2,   2,   2,   2,   2,   2,   2,   2, 105, 106, 105, 106, 105],
		[114, 113, 114, 113, 114,   2,   2,   2,   2,   8,   8,   8,   2,   2,   2,   2,   2,   2,   2,   2,   2,   2,   2,   2,   2,   2,   2, 113, 114, 113, 114, 113],
		[106, 105, 106, 105, 106,   2,   2,   2,   2,   8,   8,   8,   2,   2,   2,   2,   2,   2,   2,   2,   2,   2,   2,   2,   2,   2,   2, 105, 106, 105, 106, 105],
		[114, 113, 114, 113, 114,   2,   2,   2,   2,   8,   8,   8,   2,   2,   2,   2,   2,   2,   2,   2,   2,   2,   2,   2,   2,   2,   2, 113, 114, 113, 114, 113],
		[106, 105, 106, 105, 106,   2,   2,   2,   2,   8,   8,   8,   2,   2,   2,   2,   2,   2,   2,   2,   2,   2,   2,   2,   2,   2,   2, 105, 106, 105, 106, 105],
		[114, 113, 114, 113, 114,   2,   2,   2,   2,   8,   8,   8,   2,   2,   2,   2,   2,   2,   2,   2,   2,   2,   2,   2,   2,   2,   2, 113, 114, 113, 114, 113],
		[106, 105, 106, 105, 106,   2,   2,   2,   2,   8,  38,   8,   2,   2,   2,   2,   2,   2,   2,   2,   2,   2,   2,   2,   2,   2,   2, 105, 106, 105, 106, 105],
		[114, 113, 114, 113, 114,   2,   2,   2,   2,   8,   8,   8,   2,   2,   2,   2,   2,   2,   2,   2,   2,   2,   2,   2,   2,   2,   2, 113, 114, 113, 114, 113],
		[106, 105, 106, 105, 106,   2,   2,   2,   2,   8,   8,   8,   2,   2,   2,   2,   2,   2,   2,   2,   2,   2,   2,   2,   2,   2,   2, 105, 106, 105, 106, 105],
		[114, 113, 114, 113, 114,   2,   2,   2,   2,   8,   8,   8,   2,   2,   2,   2,   2,   2,   2,   2,   2,   2,   2,   2,   2,   2,   2, 113, 114, 113, 114, 113],
		[106, 105, 106, 105, 106,   2,   2,   2,   2,   8,   8,   8,   2,   2,   2,   2,   2,   2,   2,   2,   2,   2,   2,   2,   2,   2,   2, 105, 106, 105, 106, 105],
		[114, 113, 114, 113, 114,   2,   2,   2,   2,   8,   8,   8,   2,   2,   2,   2,   2,   2,   2,   2,   2,   2,   2,   2,   2,   2,   2, 113, 114, 113, 114, 113],
		[106, 105, 106, 105, 106,   2,   2,   2,   2,   2,   2,   2,   2,   2,   2,   2,   2,   2,   2,   2,   2,   2,   2,   2,   2,   2,   2, 105, 106, 105, 106, 105],
		[114, 113, 114, 113, 114,   2,   2,   2,   2,   2,   2,   2,   2,   2,   2,   2,   2,   2,   2,   2,   2,   2,   2,   2,   2,   2,   2, 113, 114, 113, 114, 113],
		[106, 105, 106, 105, 106,   2,   2,   2,   2,   2,   2,   2,   2,   2,   2,   2,   2,   2,   2,   2,   2,   2,   8,   8,   8,   2,   2, 105, 106, 105, 106, 105],
		[114, 113, 114, 113, 114,   2,   2,   2,   2,   2,   2,   2,   2,   2,   2,   2,   2,   2,   2,   2,   2,   2,   8,   8,   8,   2,   2, 113, 114, 113, 114, 113],
		[106, 105, 106, 105, 106,   2,   2,   2,   2,   2,   2,   2,   2,   2,   2,   2,   2,   2,   2,   2,   2,   2,   2,   2,   2,   2,   2, 105, 106, 105, 106, 105],
		[114, 113, 114, 113, 114,   2,   2,   2,   2,   2,   2,   2,   2,   2,   2,  38,   2,   2,   2,   2,   2,   2,   2,   2,   2,   2,   2, 113, 114, 113, 114, 113],
		[106, 105, 106, 105, 106,   2,   2,   2,   2,   2,   2,   2,   2,   2,   2,   2,   2,   2,   2,   2,   2,   2,   2,   2,   2,   2,   2, 105, 106, 105, 106, 105],
		[114, 113, 114, 113, 114,   2,   2,   2,   2,   2,   2,   2,   2,   2,   2,   2,   2,   2,   2,   2,   2,   2,   2,   2,   2,   2,   2, 113, 114, 113, 114, 113],
		[106, 105, 106, 105, 106,   2,   2,   2,   2,   8,   8,   8,   2,   2,2313,2314,2315,2337,2338,   2,   2,   2,   2,   2,   2,   2,   2, 105, 106, 105, 106, 105],
		[114, 113, 114, 113, 114,   2,   2,   2,   2,   8,   8,   8,   2,   2,2321,2322,2323,2345,2346,   2,   2,   2,   2,   2,   2,   2,   2, 113, 114, 113, 114, 113],
		[106, 105, 106, 105, 106,   2,   2,   2,   2,   8,   8,   8,   2,   2,2329,2330,2331,2353,2354,   2,   2,   2,   2,   2,   2,   2,   2, 105, 106, 105, 106, 105],
		[114, 113, 114, 113, 114,   2,   2,   2,   2,   8,   8,   8,   2,   2,   2,   2,   2,   2,   2,   2,   2,   2,   2,   2,   2,   2,   2, 113, 114, 113, 114, 113],
		[106, 105, 106, 105, 106,   2,   2,   2,   2,   2,   2,   2,   2,   2,   2,   2,   2,   2,   2,   2,   2,   2,   2,   2,   2,   2,   2, 105, 106, 105, 106, 105],
		[114, 113, 114, 113, 114,   2,   2,   2,   2,   2,   2,   2,   2,   2,   2,   2,   2,   2,   2,   2,   2,   2,   2,   2,   2,   2,   2, 113, 114, 113, 114, 113],
		[106, 105, 106, 105, 106,   2,   2,   2,   2,   2,   2,   2,   2,   2,   2,   2,   2,   2,   2,   2,   2,   2,   2,   2,   2,   2,   2, 105, 106, 105, 106, 105],
		[114, 113, 114, 113, 114,   2,   2,   2,   2,   2,   2,   2,   2,   2,   2,   2,   2,   2,   2,   2,   2,   2,   2,   2,   2,   2,   2, 113, 114, 113, 114, 113],
		[106, 105, 106, 105, 106,   2,   2,   2,   2,   2,   2,   2,   2,   2,   2,   2,   2,   2,   2,   2,   2,   2,   2,   2,   2,   2,   2, 105, 106, 105, 106, 105],
		[114, 113, 114, 113, 114,   2,   2,   2,   2,   2,   2,   2,   2,   2,   2,   2,   2,   2,   2,   2,   2,   2,   2,   2,   2,   2,   2, 113, 114, 113, 114, 113],
		[106, 105, 106, 105, 106,   2,   2,   2,   2,   2,   2,   2,   2,   2,   2,   2,   2,   2,   2,   2,   2,   2,   2,   2,   2,   2,   2, 105, 106, 105, 106, 105],
		[114, 113, 114, 113, 114,   2,   2,   2,   2,   2,   2,   2,   2,   2,   2,   2,   2,   2,   2,   2,   2,   2,   2,   2,   2,   2,   2, 113, 114, 113, 114, 113],
		[106, 105, 106, 105, 106,   2,   2,   2,   2,   2,   2,   2,   2,   2,   2,   2,   2,   2,   2,   2,   2,   2,   2,   2,   2,   2,   2, 105, 106, 105, 106, 105],
		[114, 113, 114, 113, 114,   2,   2,   2,   2,   2,   2,   2,   2,   2,   8,   8,   8,   8,   8,   2,   2,   2,   2,   2,   2,   2,   2, 113, 114, 113, 114, 113],
		[106, 105, 106, 105, 106,   2,   2,   2,   2,   2,   2,   2,   2,   2,   8,   8,   8,   8,   8,   2,   2,   2,   2,   2,   2,   2,   2, 105, 106, 105, 106, 105],
		[114, 113, 114, 113, 114,   2,   2,   2,   2,   2,   2,   2,   2,   2,   8,   8,  38,   8,   8,   2,   2,   2,   2,   2,   2,   2,   2, 113, 114, 113, 114, 113],
		[106, 105, 106, 105, 106,   2,   2,   2,   2,   2,   2,   2,   2,   2,   8,   8,   8,   8,   8,   2,   2,   2,   2,   2,   2,   2,   2, 105, 106, 105, 106, 105],
		[114, 113, 114, 113, 114,   2,   2,   2,   2,   2,   2,   2,   2,   2,   8,   8,   8,   8,   8,   2,   2,   2,   2,   2,   2,   2,   2, 113, 114, 113, 114, 113],
		[106, 105, 106, 105, 106,  99, 100,  99, 100,  99, 100,  99, 100,  99, 100,  99, 100,  99, 100,  99, 100,  99, 100,  99, 100,  99, 100, 105, 106, 105, 106, 105],
		[114, 113, 114, 113, 114, 113, 114, 113, 114, 113, 114, 113, 114, 113, 114, 113, 114, 113, 114, 113, 114, 113, 114, 113, 114, 113, 114, 113, 114, 113, 114, 113],
		[106, 105, 106, 105, 106, 105, 106, 105, 106, 105, 106, 105, 106, 105, 106, 105, 106, 105, 106, 105, 106, 105, 106, 105, 106, 105, 106, 105, 106, 105, 106, 105],
		[114, 113, 114, 113, 114, 113, 114, 113, 114, 113, 114, 113, 114, 113, 114, 113, 114, 113, 114, 113, 114, 113, 114, 113, 114, 113, 114, 113, 114, 113, 114, 113],
		[106, 105, 106, 105, 106, 105, 106, 105, 106, 105, 106, 105, 106, 105, 106, 105, 106, 105, 106, 105, 106, 105, 106, 105, 106, 105, 106, 105, 106, 105, 106, 105],
		[114, 113, 114, 113, 114, 113, 114, 113, 114, 113, 114, 113, 114, 113, 114, 113, 114, 113, 114, 113, 114, 113, 114, 113, 114, 113, 114, 113, 114, 113, 114, 113]
	],
	"collision" : [
		[  0,   0,   0,   0,   0,   0,   0,   0,   0,   0,   0,   0,   0,   0,   0,   0,   0,   0,   0,   0,   0,   0,   0,   0,   0,   0,   0,   0,   0,   0,   0,   0],
		[  0,   0,   0,   0,   0,   0,   0,   0,   0,   0,   0,   0,   0,   0,   0,   0,   0,   0,   0,   0,   0,   0,   0,   0,   0,   0,   0,   0,   0,   0,   0,   0],
		[  0,   0,   0,   0,   0,   0,   0,   0,   0,   0,   0,   0,   0,   0,   0,   0,   0,   0,   0,   0,   0,   0,   0,   0,   0,   0,   0,   0,   0,   0,   0,   0],
		[  0,   0,   0,   0,   0,   0,   0,   0,   0,   0,   0,   0,   0,   0,   0,   0,   0,   0,   0,   0,   0,   0,   0,   0,   0,   0,   0,   0,   0,   0,   0,   0],
		[  0,   0,   0,   0,   0,   0,   0,   0,   0,   0,   0,   0,   0,   0,   0,   0,   0,   0,   0,   0,   0,   0,   0,   0,   0,   0,   0,   0,   0,   0,   0,   0],
		[  0,   0,   0,   0,   0,   1,   1,   1,   1,   1,   1,   1,   1,   1,   1,   1,   1,   1,   1,   1,   1,   1,   1,   1,   1,   1,   1,   0,   0,   0,   0,   0],
		[  0,   0,   0,   0,   0,   1,   1,   1,   1,   1,   1,   1,   1,   1,   1,   1,   1,   1,   1,   1,   1,   1,   1,   1,   1,   1,   1,   0,   0,   0,   0,   0],
		[  0,   0,   0,   0,   0,   1,   1,   1,   1,   1,   1,   1,   1,   1,   1,   1,   1,   1,   1,   1,   1,   1,   1,   1,   1,   1,   1,   0,   0,   0,   0,   0],
		[  0,   0,   0,   0,   0,   1,   1,   1,   1,   1,   1,   1,   1,   1,   1,   1,   1,   1,   1,   1,   1,   1,   1,   1,   1,   1,   1,   0,   0,   0,   0,   0],
		[  0,   0,   0,   0,   0,   1,   1,   1,   1,   1,   1,   1,   1,   1,   1,   1,   1,   1,   1,   1,   1,   1,   1,   1,   1,   1,   1,   0,   0,   0,   0,   0],
		[  0,   0,   0,   0,   0,   1,   1,   1,   1,   1,   1,   1,   1,   1,   1,   1,   1,   1,   1,   1,   1,   1,   1,   1,   1,   1,   1,   0,   0,   0,   0,   0],
		[  0,   0,   0,   0,   0,   1,   1,   1,   1,   1,   2,   1,   1,   1,   1,   1,   1,   1,   1,   1,   1,   1,   1,   1,   1,   1,   1,   0,   0,   0,   0,   0],
		[  0,   0,   0,   0,   0,   1,   1,   1,   1,   1,   1,   1,   1,   1,   1,   1,   1,   1,   1,   1,   1,   1,   1,   1,   1,   1,   1,   0,   0,   0,   0,   0],
		[  0,   0,   0,   0,   0,   1,   1,   1,   1,   1,   1,   1,   1,   1,   1,   1,   1,   1,   1,   1,   1,   1,   1,   1,   1,   1,   1,   0,   0,   0,   0,   0],
		[  0,   0,   0,   0,   0,   1,   1,   1,   1,   1,   1,   1,   1,   1,   1,   1,   1,   1,   1,   1,   1,   1,   1,   1,   1,   1,   1,   0,   0,   0,   0,   0],
		[  0,   0,   0,   0,   0,   1,   1,   1,   1,   1,   1,   1,   1,   1,   1,   1,   1,   1,   1,   1,   1,   1,   1,   1,   1,   1,   1,   0,   0,   0,   0,   0],
		[  0,   0,   0,   0,   0,   1,   1,   1,   1,   1,   1,   1,   1,   1,   1,   1,   1,   1,   1,   1,   1,   1,   1,   1,   1,   1,   1,   0,   0,   0,   0,   0],
		[  0,   0,   0,   0,   0,   1,   1,   1,   1,   1,   1,   1,   1,   1,   1,   1,   1,   1,   1,   1,   1,   1,   1,   1,   1,   1,   1,   0,   0,   0,   0,   0],
		[  0,   0,   0,   0,   0,   1,   1,   1,   1,   1,   1,   1,   1,   1,   1,   1,   1,   1,   1,   1,   1,   1,   1,   1,   1,   1,   1,   0,   0,   0,   0,   0],
		[  0,   0,   0,   0,   0,   1,   1,   1,   1,   1,   1,   1,   1,   1,   1,   1,   1,   1,   1,   1,   1,   1,   1,   1,   1,   1,   1,   0,   0,   0,   0,   0],
		[  0,   0,   0,   0,   0,   1,   1,   1,   1,   1,   1,   1,   1,   1,   1,   1,   1,   1,   1,   1,   1,   1,   1,   1,   1,   1,   1,   0,   0,   0,   0,   0],
		[  0,   0,   0,   0,   0,   1,   1,   1,   1,   1,   1,   1,   1,   1,   1,   1,   1,   1,   1,   1,   1,   1,   1,   1,   1,   1,   1,   0,   0,   0,   0,   0],
		[  0,   0,   0,   0,   0,   1,   1,   1,   1,   1,   1,   1,   1,   1,   1,   2,   1,   1,   1,   1,   1,   1,   1,   1,   1,   1,   1,   0,   0,   0,   0,   0],
		[  0,   0,   0,   0,   0,   1,   1,   1,   1,   1,   1,   1,   1,   1,   1,   1,   1,   1,   1,   1,   1,   1,   1,   1,   1,   1,   1,   0,   0,   0,   0,   0],
		[  0,   0,   0,   0,   0,   1,   1,   1,   1,   1,   1,   1,   1,   1,   1,   1,   1,   1,   1,   1,   1,   1,   1,   1,   1,   1,   1,   0,   0,   0,   0,   0],
		[  0,   0,   0,   0,   0,   1,   1,   1,   1,   1,   1,   1,   1,   1,   0,   0,   0,   0,   0,   1,   1,   1,   1,   1,   1,   1,   1,   0,   0,   0,   0,   0],
		[  0,   0,   0,   0,   0,   1,   1,   1,   1,   1,   1,   1,   1,   1,   0,   0,   0,   0,   0,   1,   1,   1,   1,   1,   1,   1,   1,   0,   0,   0,   0,   0],
		[  0,   0,   0,   0,   0,   1,   1,   1,   1,   1,   1,   1,   1,   1,   0,   0,   4,   4,   0,   1,   1,   1,   1,   1,   1,   1,   1,   0,   0,   0,   0,   0],
		[  0,   0,   0,   0,   0,   1,   1,   1,   1,   1,   1,   1,   1,   1,   1,   1,   1,   1,   1,   1,   1,   1,   1,   1,   1,   1,   1,   0,   0,   0,   0,   0],
		[  0,   0,   0,   0,   0,   1,   1,   1,   1,   1,   1,   1,   1,   1,   1,   1,   1,   1,   1,   1,   1,   1,   1,   1,   1,   1,   1,   0,   0,   0,   0,   0],
		[  0,   0,   0,   0,   0,   1,   1,   1,   1,   1,   1,   1,   1,   1,   1,   1,   1,   1,   1,   1,   1,   1,   1,   1,   1,   1,   1,   0,   0,   0,   0,   0],
		[  0,   0,   0,   0,   0,   1,   1,   1,   1,   1,   1,   1,   1,   1,   1,   1,   1,   1,   1,   1,   1,   1,   1,   1,   1,   1,   1,   0,   0,   0,   0,   0],
		[  0,   0,   0,   0,   0,   1,   1,   1,   1,   1,   1,   1,   1,   1,   1,   1,   1,   1,   1,   1,   1,   1,   1,   1,   1,   1,   1,   0,   0,   0,   0,   0],
		[  0,   0,   0,   0,   0,   1,   1,   1,   1,   1,   1,   1,   1,   1,   1,   1,   1,   1,   1,   1,   1,   1,   1,   1,   1,   1,   1,   0,   0,   0,   0,   0],
		[  0,   0,   0,   0,   0,   1,   1,   1,   1,   1,   1,   1,   1,   1,   1,   1,   1,   1,   1,   1,   1,   1,   1,   1,   1,   1,   1,   0,   0,   0,   0,   0],
		[  0,   0,   0,   0,   0,   1,   1,   1,   1,   1,   1,   1,   1,   1,   1,   1,   1,   1,   1,   1,   1,   1,   1,   1,   1,   1,   1,   0,   0,   0,   0,   0],
		[  0,   0,   0,   0,   0,   1,   1,   1,   1,   1,   1,   1,   1,   1,   1,   1,   1,   1,   1,   1,   1,   1,   1,   1,   1,   1,   1,   0,   0,   0,   0,   0],
		[  0,   0,   0,   0,   0,   1,   1,   1,   1,   1,   1,   1,   1,   1,   1,   1,   1,   1,   1,   1,   1,   1,   1,   1,   1,   1,   1,   0,   0,   0,   0,   0],
		[  0,   0,   0,   0,   0,   1,   1,   1,   1,   1,   1,   1,   1,   1,   1,   1,   1,   1,   1,   1,   1,   1,   1,   1,   1,   1,   1,   0,   0,   0,   0,   0],
		[  0,   0,   0,   0,   0,   1,   1,   1,   1,   1,   1,   1,   1,   1,   1,   1,   1,   1,   1,   1,   1,   1,   1,   1,   1,   1,   1,   0,   0,   0,   0,   0],
		[  0,   0,   0,   0,   0,   1,   1,   1,   1,   1,   1,   1,   1,   1,   1,   1,   2,   1,   1,   1,   1,   1,   1,   1,   1,   1,   1,   0,   0,   0,   0,   0],
		[  0,   0,   0,   0,   0,   1,   1,   1,   1,   1,   1,   1,   1,   1,   1,   1,   1,   1,   1,   1,   1,   1,   1,   1,   1,   1,   1,   0,   0,   0,   0,   0],
		[  0,   0,   0,   0,   0,   1,   1,   1,   1,   1,   1,   1,   1,   1,   1,   1,   1,   1,   1,   1,   1,   1,   1,   1,   1,   1,   1,   0,   0,   0,   0,   0],
		[  0,   0,   0,   0,   0,   0,   0,   0,   0,   0,   0,   0,   0,   0,   0,   0,   0,   0,   0,   0,   0,   0,   0,   0,   0,   0,   0,   0,   0,   0,   0,   0],
		[  0,   0,   0,   0,   0,   0,   0,   0,   0,   0,   0,   0,   0,   0,   0,   0,   0,   0,   0,   0,   0,   0,   0,   0,   0,   0,   0,   0,   0,   0,   0,   0],
		[  0,   0,   0,   0,   0,   0,   0,   0,   0,   0,   0,   0,   0,   0,   0,   0,   0,   0,   0,   0,   0,   0,   0,   0,   0,   0,   0,   0,   0,   0,   0,   0],
		[  0,   0,   0,   0,   0,   0,   0,   0,   0,   0,   0,   0,   0,   0,   0,   0,   0,   0,   0,   0,   0,   0,   0,   0,   0,   0,   0,   0,   0,   0,   0,   0],
		[  0,   0,   0,   0,   0,   0,   0,   0,   0,   0,   0,   0,   0,   0,   0,   0,   0,   0,   0,   0,   0,   0,   0,   0,   0,   0,   0,   0,   0,   0,   0,   0],
		[  0,   0,   0,   0,   0,   0,   0,   0,   0,   0,   0,   0,   0,   0,   0,   0,   0,   0,   0,   0,   0,   0,   0,   0,   0,   0,   0,   0,   0,   0,   0,   0]
	]
}