{
	"tileset" : "pkmn.png",
	"terrain" : [
		[114, 113, 114, 113, 114, 105, 106, 105, 106, 105, 106, 105, 106, 105, 106, 105, 106, 105, 106, 113, 114, 113, 114, 113],
		[106, 105, 106, 105, 106, 113, 114, 113, 114, 113, 114, 113, 114, 113, 114, 113, 114, 113, 114, 105, 106, 105, 106, 105],
		[114, 113, 114, 113, 114, 105, 106, 105, 106, 105, 106, 105, 106, 105, 106, 105, 106, 105, 106, 113, 114, 113, 114, 113],
		[106, 105, 106, 105, 106, 113, 114, 113, 114, 113, 114, 113, 114, 113, 114, 113, 114, 113, 114, 105, 106, 105, 106, 105],
		[114, 113, 114, 113, 114, 121, 122, 121, 122, 121, 122, 121, 122, 121, 122, 121, 122, 121, 122, 113, 114, 113, 114, 113],
		[106, 105, 106, 105, 106,   2,   2,   2,   2,   8,   8,   8,   2,   2,   2,   2,   2,   2,   2, 105, 106, 105, 106, 105],
		[114, 113, 114, 113, 114,   2,   2,   2,   2,   8,   8,   8,   2,   2,   2,   2,   2,   2,   2, 113, 114, 113, 114, 113],
		[106, 105, 106, 105, 106,   2,   2,   2,   2,   8,   8,   8,   2,   2,   2,   2,   2,   2,   2, 105, 106, 105, 106, 105],
		[114, 113, 114, 113, 114,   2,   2,   2,   2,   8,   8,   8,   2,   2,   2,   2,   2,   2,   2, 113, 114, 113, 114, 113],
		[106, 105, 106, 105, 106,   2,   2,   2,   2,   8,   8,   8,   2,   2,   2,   2,   2,   2,   2, 105, 106, 105, 106, 105],
		[114, 113, 114, 113, 114,   2,   2,   2,   2,   8,   8,   8,   2,   2,   2,   2,   2,   2,   2, 113, 114, 113, 114, 113],
		[106, 105, 106, 105, 106,   2,   2,   2,   2,   8,  38,   8,   2,   2,   2,   2,   2,   2,   2, 105, 106, 105, 106, 105],
		[114, 113, 114, 113, 114,   2,   2,   2,   2,   8,   8,   8,   2,   2,   2,   2,   2,   2,   2, 113, 114, 113, 114, 113],
		[106, 105, 106, 105, 106,   2,   2,   2,   2,   8,   8,   8,   2,   2,   2,   2,   2,   2,   2, 105, 106, 105, 106, 105],
		[114, 113, 114, 113, 114,   2,   2,   2,   2,   8,   8,   8,   2,   2,   2,   2,   2,   2,   2, 113, 114, 113, 114, 113],
		[106, 105, 106, 105, 106,   2,   2,   2,   2,   8,   8,   8,   2,   2,   2,   2,   2,   2,   2, 105, 106, 105, 106, 105],
		[114, 113, 114, 113, 114,   2,   2,   2,   2,   8,   8,   8,   2,   2,   2,   2,   2,   2,   2, 113, 114, 113, 114, 113],
		[106, 105, 106, 105, 106,   2,   2,   2,   2,   2,   2,   2,   2,   2,   2,   2,   2,   2,   2, 105, 106, 105, 106, 105],
		[114, 113, 114, 113, 114,   2,   2,   2,   2,   2,   2,   2,   2,   2,   2,   2,   2,   2,   2, 113, 114, 113, 114, 113],
		[106, 105, 106, 105, 106,  99, 100,  99, 100,  99, 100,  99, 100,  99, 100,  99, 100,  99, 100, 105, 106, 105, 106, 105],
		[114, 113, 114, 113, 114, 113, 114, 113, 114, 113, 114, 113, 114, 113, 114, 113, 114, 113, 114, 113, 114, 113, 114, 113],
		[106, 105, 106, 105, 106, 105, 106, 105, 106, 105, 106, 105, 106, 105, 106, 105, 106, 105, 106, 105, 106, 105, 106, 105],
		[114, 113, 114, 113, 114, 113, 114, 113, 114, 113, 114, 113, 114, 113, 114, 113, 114, 113, 114, 113, 114, 113, 114, 113],
		[106, 105, 106, 105, 106, 105, 106, 105, 106, 105, 106, 105, 106, 105, 106, 105, 106, 105, 106, 105, 106, 105, 106, 105],
		[114, 113, 114, 113, 114, 113, 114, 113, 114, 113, 114, 113, 114, 113, 114, 113, 114, 113, 114, 113, 114, 113, 114, 113]
	],
	"collision" : [
		[  0,   0,   0,   0,   0,   0,   0,   0,   0,   0,   0,   0,   0,   0,   0,   0,   0,   0,   0,   0,   0,   0,   0,   0],
		[  0,   0,   0,   0,   0,   0,   0,   0,   0,   0,   0,   0,   0,   0,   0,   0,   0,   0,   0,   0,   0,   0,   0,   0],
		[  0,   0,   0,   0,   0,   0,   0,   0,   0,   0,   0,   0,   0,   0,   0,   0,   0,   0,   0,   0,   0,   0,   0,   0],
		[  0,   0,   0,   0,   0,   0,   0,   0,   0,   0,   0,   0,   0,   0,   0,   0,   0,   0,   0,   0,   0,   0,   0,   0],
		[  0,   0,   0,   0,   0,   0,   0,   0,   0,   0,   0,   0,   0,   0,   0,   0,   0,   0,   0,   0,   0,   0,   0,   0],
		[  0,   0,   0,   0,   0,   1,   1,   1,   1,   1,   1,   1,   1,   1,   1,   1,   1,   1,   1,   0,   0,   0,   0,   0],
		[  0,   0,   0,   0,   0,   1,   1,   1,   1,   1,   1,   1,   1,   1,   1,   1,   1,   1,   1,   0,   0,   0,   0,   0],
		[  0,   0,   0,   0,   0,   1,   1,   1,   1,   1,   1,   1,   1,   1,   1,   1,   1,   1,   1,   0,   0,   0,   0,   0],
		[  0,   0,   0,   0,   0,   1,   1,   1,   1,   1,   1,   1,   1,   1,   1,   1,   1,   1,   1,   0,   0,   0,   0,   0],
		[  0,   0,   0,   0,   0,   1,   1,   1,   1,   1,   1,   1,   1,   1,   1,   1,   1,   1,   1,   0,   0,   0,   0,   0],
		[  0,   0,   0,   0,   0,   1,   1,   1,   1,   1,   1,   1,   1,   1,   1,   1,   1,   1,   1,   0,   0,   0,   0,   0],
		[  0,   0,   0,   0,   0,   1,   1,   1,   1,   1,   2,   1,   1,   1,   1,   1,   1,   1,   1,   0,   0,   0,   0,   0],
		[  0,   0,   0,   0,   0,   1,   1,   1,   1,   1,   1,   1,   1,   1,   1,   1,   1,   1,   1,   0,   0,   0,   0,   0],
		[  0,   0,   0,   0,   0,   1,   1,   1,   1,   1,   1,   1,   1,   1,   1,   1,   1,   1,   1,   0,   0,   0,   0,   0],
		[  0,   0,   0,   0,   0,   1,   1,   1,   1,   1,   1,   1,   1,   1,   1,   1,   1,   1,   1,   0,   0,   0,   0,   0],
		[  0,   0,   0,   0,   0,   1,   1,   1,   1,   1,   1,   1,   1,   1,   1,   1,   1,   1,   1,   0,   0,   0,   0,   0],
		[  0,   0,   0,   0,   0,   1,   1,   1,   1,   1,   1,   1,   1,   1,   1,   1,   1,   1,   1,   0,   0,   0,   0,   0],
		[  0,   0,   0,   0,   0,   1,   1,   1,   1,   1,   1,   1,   1,   1,   1,   1,   1,   1,   1,   0,   0,   0,   0,   0],
		[  0,   0,   0,   0,   0,   1,   1,   1,   1,   1,   1,   1,   1,   1,   1,   1,   1,   1,   1,   0,   0,   0,   0,   0],
		[  0,   0,   0,   0,   0,   0,   0,   0,   0,   0,   0,   0,   0,   0,   0,   0,   0,   0,   0,   0,   0,   0,   0,   0],
		[  0,   0,   0,   0,   0,   0,   0,   0,   0,   0,   0,   0,   0,   0,   0,   0,   0,   0,   0,   0,   0,   0,   0,   0],
		[  0,   0,   0,   0,   0,   0,   0,   0,   0,   0,   0,   0,   0,   0,   0,   0,   0,   0,   0,   0,   0,   0,   0,   0],
		[  0,   0,   0,   0,   0,   0,   0,   0,   0,   0,   0,   0,   0,   0,   0,   0,   0,   0,   0,   0,   0,   0,   0,   0],
		[  0,   0,   0,   0,   0,   0,   0,   0,   0,   0,   0,   0,   0,   0,   0,   0,   0,   0,   0,   0,   0,   0,   0,   0],
		[  0,   0,   0,   0,   0,   0,   0,   0,   0,   0,   0,   0,   0,   0,   0,   0,   0,   0,   0,   0,   0,   0,   0,   0]
	]
}